
NO ./TEXTURES/north.xpm
SO ./TEXTURES/sawth.xpm
EA ./TEXTURES/west.xpm
WE ./TEXTURES/50_tex(1).xpm

F   108,125,255
C   96,96,96

        11111111111111111111111111111
        11000000000000000000000000001
        11000000000000000000000000001
        11000000000000000000000000001
        11000000000000000000000000001
        11000000000000000000000000001
        11000000000000000000000000001
        11111111000111111111111111111111
  111111110000000001111             10001111111111111
11000000000000111111111111111111111111111111
11000000000000000000000000001
11000000000000000000000000001
11000000000000000000000000001
11000000000000000000000000001
11000000000000000000000000001
110000010000000000000000000001
110000001000000000000000000001
11000000100000000000000000001
11000000010000000000000000001
11000000010000000000000000001
11000000000000000000000000001
11000000000000000000011111111
11000000000000000000000000001
11000000000000000000000000001
11000000000000000000000000001
11000000000000000000000000001
11000000000000000000000000001
11000000000000000000000000001
11000000000000000000000000001
11000000000000000000000000001
11000000000000000000000000001
11000000000000000000000000001
11000000000000000000000000001
11000000000000000000011111111
11000000000000000000000000001
11000000000000S00000000000001
11000000000000000000000000001
11000000000000000000000000001
11000000000000000000000000001
11000000000000000000000000001
11000000000000000000000000001
11000000000000000000000000001
11000000000000000000000000001
11000000000000000000000000001
11000000000000000000000000001
11000000000000000000000000001
11000000000000000000000000001
11000000000000000000000000001
11111111111111111111111111111