NO ./TEXTURES/north.xpm
SO ./TEXTURES/sawth.xpm
EA ./TEXTURES/west.xpm
WE ./TEXTURES/50_tex(1).xpm

F 0,0,255
C 96,96,96

d111111111111111111111111
d10000000000000000000000N1
d1000000000000000000000001
d1000000000000000000000001
d1000000000000000000000001
111111111011000001110111111111111
111000000000000000000000111111
11110111111111011100000010001
11110111111111011101010010001
11000000000000000000000000001
11111111111111111111111111111