11111111111
10P00100001
10010000001
10000100001
10010010001
10100000001
10100000001
11111111111