
NO ./texteres/IMG_1721.xpm
SO ./texteres/IMG_1721.xpm
EA ./texteres/IMG_1721.xpm
WE ./texteres/IMG_1721.xpm

F 220,100,0
C 255,30,0

        1111111111111111111111111
        1000000000110000000000001
        1011000001110000000000001
        1001000000000000000000001
111111111011000000000000000000001
100000000011000000000000000111111
11110000000000000000000010001
11110100000000000001010010001
11000000000000000000000010001
10000000000000000000000100001
10000000000000000000000000001
11000000000000000000000000P01
11111111111111111111111111111