1111111111111111111111111
1000000000110000000000001
1000N00001110000000000001
1001000000000000000000001
1110000000000100010000001
1000000000000010100001001
1110000000000001000000001
1111000000000000000101001
1100000010000000000000001
100000000000000N000000001
1000000000000000000000001
1100000000000000000000011
1111111111111111111111111