NO ./texteres/IMG_1721.xpm
SO ./texteres/IMG_1721.xpm
EA ./texteres/IMG_1721.xpm
WE ./texteres/IMG_1721.xpm

F 220,100,0
C 255,30,0

11111111111111111111111111111
11111111101100000111000000001
10000000001100000111011111111
11000000000000000101110000001
10000000000001100000001001001
11000000000001010000000001001
10000000000010000000000000001
1000000000000000000000N000001
11000010000000000000000000001
11111111111111111111111111111