NO ./TEXTURES/50_tex(1).xpm
SO wallpaperflare.com_wallpaper.xpm
EA ./TEXTURES/50_tex(1).xpm
WE wallpaperflare.com_wallpaper.xpm

F 220,100,0
C 255,30,0

1111111111111111111111111
1000000000000000000000001
1000000000000000000000001
100000000000000N000000001
1000000000000000000000001
111111111011000001110111111111111
111000000000000000000000111111
11110111111111011100000010001
11110111111111011101010010001
11000000000000000000000000001
11111111111111111111111111111