11111111111111111111111111111111
10000001000000000000000000000001
100P0000100000000000000000000001
10000001000000000000000000000001
11111111111111111111111111111111