NO ./texteres/IMG_1721.xpm
SO ./texteres/IMG_1721.xpm
EA ./texteres/IMG_1721.xpm
WE ./texteres/IMG_1721.xpm

F 220,100,0
C 255,30,0

1111111111111111111111111
1000000000110000000000001
1011000001110000000000001
1001000000000000000000001
1110000000000000000000001
1000000000000000000001001
1110000000000000000000001
11110000000000N0000101001
1100000010000000000000001
1000000000000000000000001
1000000000000000000000001
1100000000000000000000011
1111111111111111111111111