11111111111
1P000100001
10010000001
10000100001
10010000001
10000010001
10010010001
10010000001
10000010001
10010010001
10000000101
10100000001
10000000101
10100100001
10000000101
10000100001
11111111111