NO ./texteres/IMG_1721.xpm
SO ./xpm_file/wall.xpm
EA ./texteres/IMG_1721.xpm
WE ./xpm_file/wall.xpm

F 220,100,0
C 255,30,0

        1111111111111111111111111
        1000000000110000000000001
        1011000001110000000000001
        100100W000000000000000001
        1111111110110000001100011
111111110011000001110111111111111
11110111111111011100000010001
11110111111111011101010010001
11000000110101011100000010001
10000000000000001100000000001
10000000000000001101010010001
110000011101010111110111100111
11110111 1110101 101111010001
11111111 1111111 111111111111